#######################################
# Syntax Coloring Map For KiteLib
#######################################

#######################################
# Datatypes (KEYWORD1)
#######################################

KiteLib	KEYWORD1
Kite	KEYWORD1
Module	KEYWORD1

ESP8266	KEYWORD1
HC05	KEYWORD1
JDY08	KEYWORD1
RF69	KEYWORD1
RFM95	KEYWORD1
RFM96	KEYWORD1
RFM97	KEYWORD1
RFM98	KEYWORD1
SX1231	KEYWORD1
SX1272	KEYWORD1
SX1273	KEYWORD1
SX1276	KEYWORD1
SX1277	KEYWORD1
SX1278	KEYWORD1
SX1279	KEYWORD1
XBee	KEYWORD1
XBeeSerial	KEYWORD1

MQTTClient	KEYWORD1
HTTPClient	KEYWORD1
RTTYClient	KEYWORD1

#######################################
# Methods and Functions (KEYWORD2)
#######################################

# KiteLib
ModuleA	KEYWORD2
ModuleB	KEYWORD2
Module	KEYWORD2

# SX127x/RFM9x + RF69
begin	KEYWORD2
beginFSK	KEYWORD2
transmit	KEYWORD2
receive	KEYWORD2
scanChannel	KEYWORD2
sleep	KEYWORD2
standby	KEYWORD2
transmitDirect	KEYWORD2
receiveDirect	KEYWORD2
packetMode	KEYWORD2
setDio0Action	KEYWORD2
setDio1Action	KEYWORD2
startTransmit	KEYWORD2
startReceive	KEYWORD2
readData	KEYWORD2
setBandwidth	KEYWORD2
setSpreadingFactor	KEYWORD2
setCodingRate	KEYWORD2
setFrequency	KEYWORD2
setSyncWord	KEYWORD2
setOutputPower	KEYWORD2
setCurrentLimit	KEYWORD2
setPreambleLength	KEYWORD2
setGain	KEYWORD2
getFrequencyError	KEYWORD2
getRSSI	KEYWORD2
getSNR	KEYWORD2
getDataRate	KEYWORD2
setBitRate	KEYWORD2
setRxBandwidth	KEYWORD2
setFrequencyDeviation	KEYWORD2
setNodeAddress	KEYWORD2
setBroadcastAddress	KEYWORD2
disableAddressFiltering	KEYWORD2

# RF69-specific
setAESKey	KEYWORD2
enableAES	KEYWORD2
disableAES	KEYWORD2
getTemperature	KEYWORD2
setAmbientTemperature	KEYWORD2

# ESP8266
join	KEYWORD2
reset	KEYWORD2

# XBee
setDestinationAddress	KEYWORD2
setPanId	KEYWORD2
getPacketSource	KEYWORD2
getPacketData	KEYWORD2

# HTTP
get	KEYWORD2
post	KEYWORD2

# MQTT
connect	KEYWORD2
disconnect	KEYWORD2
publish	KEYWORD2
subscribe	KEYWORD2
unsubscribe	KEYWORD2
ping	KEYWORD2
check	KEYWORD2

# RTTY
idle	KEYWORD2
byteArr	KEYWORD2

# TransportLayer
openTransportConnection	KEYWORD2
closeTransportConnection	KEYWORD2
send	KEYWORD2
receive	KEYWORD2
getNumBytes	KEYWORD2

#######################################
# Constants (LITERAL1)
#######################################

ERR_NONE	LITERAL1
ERR_UNKNOWN	LITERAL1

ERR_CHIP_NOT_FOUND	LITERAL1
ERR_EEPROM_NOT_INITIALIZED	LITERAL1
ERR_PACKET_TOO_LONG	LITERAL1
ERR_TX_TIMEOUT	LITERAL1
ERR_RX_TIMEOUT	LITERAL1
ERR_CRC_MISMATCH	LITERAL1
ERR_INVALID_BANDWIDTH	LITERAL1
ERR_INVALID_SPREADING_FACTOR	LITERAL1
ERR_INVALID_CODING_RATE	LITERAL1
ERR_INVALID_BIT_RANGE	LITERAL1
ERR_INVALID_FREQUENCY	LITERAL1
ERR_INVALID_OUTPUT_POWER	LITERAL1
PREAMBLE_DETECTED	LITERAL1
CHANNEL_FREE	LITERAL1
ERR_SPI_WRITE_FAILED	LITERAL1
ERR_INVALID_CURRENT_LIMIT	LITERAL1
ERR_INVALID_PREAMBLE_LENGTH	LITERAL1
ERR_INVALID_GAIN	LITERAL1
ERR_WRONG_MODEM	LITERAL1

ERR_INVALID_BIT_RATE	LITERAL1
ERR_INVALID_FREQUENCY_DEVIATION	LITERAL1
ERR_INVALID_BIT_RATE_BW_RATIO	LITERAL1
ERR_INVALID_RX_BANDWIDTH	LITERAL1
ERR_INVALID_SYNC_WORD	LITERAL1

ERR_AT_FAILED	LITERAL1
ERR_URL_MALFORMED	LITERAL1
ERR_RESPONSE_MALFORMED_AT	LITERAL1
ERR_RESPONSE_MALFORMED	LITERAL1
ERR_MQTT_CONN_VERSION_REJECTED	LITERAL1
ERR_MQTT_CONN_ID_REJECTED	LITERAL1
ERR_MQTT_CONN_SERVER_UNAVAILABLE	LITERAL1
ERR_MQTT_CONN_BAD_USERNAME_PASSWORD	LITERAL1
ERR_MQTT_CONN_NOT_AUTHORIZED	LITERAL1
ERR_MQTT_UNEXPECTED_PACKET_ID	LITERAL1
ERR_MQTT_NO_NEW_PACKET_AVAILABLE	LITERAL1
MQTT_SUBS_SUCCESS_QOS_0	LITERAL1
MQTT_SUBS_SUCCESS_QOS_1	LITERAL1
MQTT_SUBS_SUCCESS_QOS_2	LITERAL1
ERR_MQTT_SUBS_FAILED	LITERAL1

ERR_CMD_MODE_FAILED	LITERAL1
ERR_FRAME_MALFORMED	LITERAL1
ERR_FRAME_INCORRECT_CHECKSUM	LITERAL1
ERR_FRAME_UNEXPECTED_ID	LITERAL1

ASCII	LITERAL1
ASCII_EXTENDED	LITERAL1
ITA2	LITERAL1
ERR_INVALID_RTTY_SHIFT	LITERAL1
ERR_UNSUPPORTED_ENCODING	LITERAL1
